####################################################
#                $                   #             #
#                                    #             #
##########################  #################  #####
#                                                  #
###################   ################   ###########
#                            #                     #
#                            #                     #
####################################  ##############
#                        @                         #
#                                                  #
#####  ###################  #####  #################
#                  #                               #
#                  #                               #
##################################   ###############
#                                                  #
#                                                  #
####################################################