####################
#$                 #
#    ####  ######  #
#   ##        #    #
##                ##
#    #        ##   #
#  ######  ####    #
#                @ #
####################